ตั้ง	VV	O	B_CLS
อยู่	VV	O	I_CLS
ที่	PS	O	I_CLS
หมู่	NN	O	I_CLS
_	PU	O	I_CLS
2	NU	O	I_CLS
_	PU	O	I_CLS
บ้านคอก	NN	O	I_CLS
ช้าง	NN	O	I_CLS
_	PU	O	I_CLS
ตำบล	NN	O	I_CLS
ใน	PS	O	I_CLS
วงเหนือ	NN	O	I_CLS
_	PU	O	I_CLS
อำเภอ	NN	O	I_CLS
ละอุ่น	NN	O	I_CLS
_	PU	O	I_CLS
จังหวัดระนอง	NN	O	I_CLS
_	PU	O	I_CLS
เป็น	VV	O	I_CLS
แหล่ง	NN	O	I_CLS
โบราณคดี	NN	O	I_CLS
ประเภท	NN	O	I_CLS
ถ้ำ	NN	O	I_CLS
_	PU	O	I_CLS
มี	VV	O	I_CLS
หลักฐาน	NN	O	I_CLS
ทาง	NN	O	I_CLS
โบราณคดี	NN	O	I_CLS
กระจาย	VV	O	I_CLS
ตัว	NN	O	I_CLS
อยู่	VV	O	I_CLS
บ้าง	PR	O	I_CLS
โบราณวัตถุ	NN	O	I_CLS
ที่	CC	O	I_CLS
สำคัญ	VV	O	I_CLS
_	PU	O	I_CLS
อาทิ	CC	O	I_CLS
_	PU	O	I_CLS
เครื่องมือ	NN	O	I_CLS
หิน	NN	O	I_CLS
กะเทาะ	VV	O	I_CLS
_	PU	O	I_CLS
หินลับ	NN	O	I_CLS
_	PU	O	I_CLS
เศษ	NN	O	I_CLS
ภาชนะ	NN	O	I_CLS
ดิน	NN	O	I_CLS
เผา	VV	O	I_CLS
_	PU	O	I_CLS
ชิ้นส่วน	NN	O	I_CLS
กระดูก	NN	O	I_CLS
มนุษย์	NN	O	I_CLS
_	PU	O	I_CLS
ชิ้นส่วน	NN	O	I_CLS
กระดูก	NN	O	I_CLS
สัตว์	NN	O	I_CLS
_	PU	O	I_CLS
อุลกมณี	NN	O	I_CLS
_	PU	O	I_CLS
ชิ้นส่วน	NN	O	I_CLS
ภาชนะ	NN	O	I_CLS
ดิน	NN	O	I_CLS
เผา	VV	O	I_CLS
สามขา	NN	O	I_CLS
_	PU	O	I_CLS
เป็นต้น	AV	O	E_CLS
