พบ	VV	O	B_CLS
หลักฐาน	NN	O	I_CLS
ยุค	NN	O	I_CLS
ก่อน	PS	O	I_CLS
ประวัติศาสตร์	NN	O	I_CLS
เป็น	VV	O	I_CLS
จำนวน	NN	O	I_CLS
มาก	VV	O	I_CLS
_	PU	O	I_CLS
บริเวณ	NN	O	I_CLS
พื้นที่	NN	O	I_CLS
อำเภอ	NN	O	I_CLS
ละอุ่น	NN	O	I_CLS
_	PU	O	I_CLS
โดย	CC	O	I_CLS
มี	VV	O	I_CLS
การ	FX	O	I_CLS
พบ	VV	O	I_CLS
หลักฐาน	NN	O	I_CLS
หลาย	AJ	O	I_CLS
ประเภท	CL	O	I_CLS
_	PU	O	I_CLS
อาทิ	CC	O	I_CLS
_	PU	O	I_CLS
เศษ	NN	O	I_CLS
ภาชนะ	NN	O	I_CLS
ดิน	NN	O	I_CLS
เผา	VV	O	I_CLS
_	PU	O	I_CLS
ชิ้นส่วน	NN	O	I_CLS
กระดูก	NN	O	I_CLS
มนุษย์	NN	O	I_CLS
_	PU	O	I_CLS
ชิ้นส่วน	NN	O	I_CLS
กระดูก	NN	O	I_CLS
สัตว์	NN	O	I_CLS
_	PU	O	I_CLS
เปลือก	NN	O	I_CLS
หอย	NN	O	I_CLS
_	PU	O	I_CLS
และ	CC	O	I_CLS
เครื่อง	NN	O	I_CLS
ประดับ	VV	O	I_CLS
เป็นต้น	AV	O	E_CLS
