ที่	NN	O	B_CLS
ตั้ง	VV	O	I_CLS
_	PU	O	I_CLS
ตำบล	NN	O	I_CLS
ปากน้ำ	NN	O	I_CLS
_	PU	O	I_CLS
อำเภอ	NN	O	I_CLS
เมืองชุมพร	NN	O	I_CLS
_	PU	O	I_CLS
จังหวัดชุมพร	NN	O	I_CLS
_	PU	O	I_CLS
เป็น	VV	O	I_CLS
ปากน้ำ	NN	O	I_CLS
ที่	CC	O	I_CLS
คลองท่าตะเภา	NN	O	I_CLS
ไหล	VV	O	I_CLS
ลง	AV	O	I_CLS
สู่	PS	O	I_CLS
ทะเล	NN	O	I_CLS
_	PU	O	I_CLS
ห่าง	VV	O	I_CLS
จาก	PS	O	I_CLS
ตัวเมือง	NN	O	I_CLS
ชุมพร	NN	O	I_CLS
ประมาณ	AJ	O	I_CLS
_	PU	O	I_CLS
10	NU	O	I_CLS
_	PU	O	I_CLS
กิโลเมตร	CL	O	I_CLS
_	PU	O	I_CLS
บริเวณ	NN	O	I_CLS
ใกล้เคียงเป็น	PS	O	I_CLS
ท่า	NN	O	I_CLS
เทียบ	VV	O	I_CLS
เรือ	NN	O	I_CLS
และ	CC	O	I_CLS
ชุมชน	NN	O	I_CLS
ชาว	FX	O	I_CLS
ประมง	NN	O	I_CLS
ขนาด	NN	O	I_CLS
ใหญ่	VV	O	I_CLS
_	PU	O	I_CLS
โดย	CC	O	I_CLS
เป็น	VV	O	I_CLS
ชุมชน	NN	O	I_CLS
ชาว	FX	O	I_CLS
ไทย	NN	O	I_CLS
-	PU	O	I_CLS
จีน	NN	O	I_CLS
ไหหลำ	NN	O	I_CLS
และ	CC	O	I_CLS
แต้จิ๋ว	NN	O	I_CLS
ดั้งเดิม	AJ	O	I_CLS
_	PU	O	I_CLS
ดัง	PS	O	I_CLS
ปรากฏ	VV	O	I_CLS
ศาล	NN	O	I_CLS
เจ้า	NN	O	I_CLS
ชาว	FX	O	I_CLS
จีน	NN	O	I_CLS
อยู่	VV	O	I_CLS
ใน	PS	O	I_CLS
ชุมชน	NN	O	I_CLS
_	PU	O	I_CLS
มี	VV	O	I_CLS
แหล่ง	NN	O	I_CLS
ท่องเที่ยว	VV	O	I_CLS
ที่	CC	O	I_CLS
โดดเด่น	VV	O	I_CLS
_	PU	O	I_CLS
ได้แก่	CC	O	I_CLS
_	PU	O	I_CLS
เขา	NN	O	I_CLS
มัทรี	NN	O	I_CLS
_	PU	O	I_CLS
อนุสาวรีย์ยุวชน	NN	O	I_CLS
ทหาร	NN	O	I_CLS
_	PU	O	I_CLS
และ	CC	O	I_CLS
มาลิก	NN	O	I_CLS
เจดีย์	NN	O	I_CLS
บน	PS	O	I_CLS
เกาะ	NN	O	I_CLS
มัตโพน	NN	O	I_CLS
_	PU	O	I_CLS
เป็นต้น	AV	O	E_CLS
