เป็น	VV	O	B_CLS
ซาก	NN	O	I_CLS
เรือ	NN	O	I_CLS
รบ	VV	O	I_CLS
ของ	PS	O	I_CLS
ญี่ปุ่น	NN	O	I_CLS
สมัย	NN	O	I_CLS
สงคราม	NN	O	I_CLS
โลก	NN	O	I_CLS
ครั้ง	CL	O	I_CLS
ที่	PS	O	I_CLS
_	PU	O	I_CLS
2	NU	O	I_CLS
_	PU	O	I_CLS
ซึ่ง	CC	O	I_CLS
ใน	PS	O	I_CLS
ระหว่าง	PS	O	I_CLS
สงคราม	NN	O	I_CLS
กอง	NN	O	I_CLS
ทัพ	NN	O	I_CLS
ญี่ปุ่น	NN	O	I_CLS
ได้	AX	O	I_CLS
ใช้	VV	O	I_CLS
พื้นที่	NN	O	I_CLS
ใน	PS	O	I_CLS
ตำบลปากจั่น	NN	O	I_CLS
_	PU	O	I_CLS
อำเภอ	NN	O	I_CLS
กระบุรี	NN	O	I_CLS
_	PU	O	I_CLS
เป็น	VV	O	I_CLS
ท่า	NN	O	I_CLS
เรือ	NN	O	I_CLS
เพื่อ	CC	O	I_CLS
ส่ง	VV	O	I_CLS
กำลัง	NN	O	I_CLS
บำรุง	VV	O	I_CLS
ไป	AV	O	I_CLS
ยัง	PS	O	I_CLS
ประเทศพม่า	NN	O	I_CLS
_	PU	O	I_CLS
ซาก	NN	O	I_CLS
เรือ	NN	O	I_CLS
อยู่	VV	O	I_CLS
บริเวณ	NN	O	I_CLS
สะพาน	NN	O	I_CLS
ข้าม	VV	O	I_CLS
แม่น้ำละ	NN	O	I_CLS
อุ่น	NN	O	I_CLS
จะ	AX	O	I_CLS
สังเกต	VV	O	I_CLS
เห็น	VV	O	I_CLS
ได้	AX	O	I_CLS
ใน	PS	O	I_CLS
เวลา	NN	O	I_CLS
น้ำ	NN	O	I_CLS
ลง	VV	O	E_CLS
