คำ	NN	O	B_CLS
ที่	CC	O	I_CLS
ใช้	VV	O	I_CLS
เรียก	VV	O	I_CLS
พระพุทธเจ้า	NN	B_GOD	I_CLS
โดย	FX	O	I_CLS
เฉพาะ	VV	O	I_CLS
_	PU	O	I_CLS
โดย	CC	O	I_CLS
ใน	PS	O	I_CLS
ทาง	NN	O	I_CLS
พระพุทธศาสนา	NN	O	I_CLS
เห็น	VV	O	I_CLS
ว่า	CC	O	I_CLS
พระองค์	PR	O	I_CLS
ทรง	VV	O	I_CLS
เป็น	VV	O	I_CLS
_	PU	O	I_CLS
"	PU	O	I_CLS
บรมครู	NN	B_GOD	I_CLS
"	PU	O	I_CLS
_	PU	O	I_CLS
หรือ	CC	O	I_CLS
สุด	AV	O	I_CLS
ยอด	VV	O	I_CLS
แห่ง	PS	O	I_CLS
ครู	NN	O	I_CLS
เพราะ	CC	O	I_CLS
ทรง	VV	O	I_CLS
คำ	NN	O	I_CLS
สั่งสอน	VV	O	I_CLS
มนุษย์	NN	O	I_CLS
เป็น	VV	O	I_CLS
จำนวน	NN	O	I_CLS
มาก	VV	O	I_CLS
ทั้ง	CC	O	I_CLS
ใน	PS	O	I_CLS
ชมพู	NN	B_LOC	I_CLS
ทวีป	NN	E_LOC	I_CLS
อัน	CC	O	I_CLS
เป็น	VV	O	I_CLS
แหล่ง	NN	O	I_CLS
กำเนิด	VV	O	I_CLS
ของ	PS	O	I_CLS
พระพุทธศาสนา	NN	O	I_CLS
_	PU	O	I_CLS
และ	CC	O	I_CLS
ใน	PS	O	I_CLS
อีก	AJ	O	I_CLS
หลาย	AJ	O	I_CLS
ชาติ	NN	O	I_CLS
หลาย	AJ	O	I_CLS
ภาษา	CL	O	I_CLS
ใน	PS	O	I_CLS
โลก	NN	O	E_CLS