เป็น	VV	O	B_CLS
ซาก	NN	O	I_CLS
เรือ	NN	B_VEH	I_CLS
รบ	VV	E_VEH	I_CLS
ของ	PS	O	I_CLS
ญี่ปุ่น	NN	B_COU	I_CLS
สมัย	NN	B_EVH	I_CLS
สงคราม	NN	I_EVH	I_CLS
โลก	NN	I_EVH	I_CLS
ครั้ง	CL	I_EVH	I_CLS
ที่	PS	I_EVH	I_CLS
_	PU	I_EVH	I_CLS
2	NU	E_EVH	I_CLS
_	PU	O	I_CLS
ซึ่ง	CC	O	I_CLS
ใน	PS	O	I_CLS
ระหว่าง	PS	O	I_CLS
สงคราม	NN	O	I_CLS
กอง	NN	O	I_CLS
ทัพ	NN	O	I_CLS
ญี่ปุ่น	NN	B_COU	I_CLS
ได้	AX	O	I_CLS
ใช้	VV	O	I_CLS
พื้นที่	NN	O	I_CLS
ใน	PS	O	I_CLS
ตำบลปากจั่น	NN	B_SUB	I_CLS
_	PU	O	I_CLS
อำเภอ	NN	B_DIS	I_CLS
กระบุรี	NN	E_DIS	I_CLS
_	PU	O	I_CLS
เป็น	VV	O	I_CLS
ท่า	NN	O	I_CLS
เรือ	NN	O	I_CLS
เพื่อ	CC	O	I_CLS
ส่ง	VV	O	I_CLS
กำลัง	NN	O	I_CLS
บำรุง	VV	O	I_CLS
ไป	AV	O	I_CLS
ยัง	PS	O	I_CLS
ประเทศพม่า	NN	B_COU	I_CLS
_	PU	O	I_CLS
ซาก	NN	O	I_CLS
เรือ	NN	O	I_CLS
อยู่	VV	O	I_CLS
บริเวณ	NN	O	I_CLS
สะพาน	NN	B_LOC	I_CLS
ข้าม	VV	I_LOC	I_CLS
แม่น้ำละ	NN	I_LOC	I_CLS
อุ่น	NN	E_LOC	I_CLS
จะ	AX	O	I_CLS
สังเกต	VV	O	I_CLS
เห็น	VV	O	I_CLS
ได้	AX	O	I_CLS
ใน	PS	O	I_CLS
เวลา	NN	O	I_CLS
น้ำ	NN	O	I_CLS
ลง	VV	O	E_CLS