ที่	NN	O	B_CLS
ตั้ง	VV	O	I_CLS
_	PU	O	I_CLS
ตำบล	NN	B_SUB	I_CLS
ปากน้ำ	NN	E_SUB	I_CLS
_	PU	O	I_CLS
อำเภอ	NN	B_DIS	I_CLS
เมืองชุมพร	NN	E_DIS	I_CLS
_	PU	O	I_CLS
จังหวัดชุมพร	NN	B_PRO	I_CLS
_	PU	O	I_CLS
เป็น	VV	O	I_CLS
ปากน้ำ	NN	O	I_CLS
ที่	CC	O	I_CLS
คลองท่าตะเภา	NN	B_NPL	I_CLS
ไหล	VV	O	I_CLS
ลง	AV	O	I_CLS
สู่	PS	O	I_CLS
ทะเล	NN	O	I_CLS
_	PU	O	I_CLS
ห่าง	VV	O	I_CLS
จาก	PS	O	I_CLS
ตัวเมือง	NN	O	I_CLS
ชุมพร	NN	O	I_CLS
ประมาณ	AJ	O	I_CLS
_	PU	O	I_CLS
10	NU	B_NUM	I_CLS
_	PU	O	I_CLS
กิโลเมตร	CL	B_MEA	I_CLS
_	PU	O	I_CLS
บริเวณ	NN	O	I_CLS
ใกล้เคียงเป็น	PS	O	I_CLS
ท่า	NN	O	I_CLS
เทียบ	VV	O	I_CLS
เรือ	NN	O	I_CLS
และ	CC	O	I_CLS
ชุมชน	NN	O	I_CLS
ชาว	FX	O	I_CLS
ประมง	NN	O	I_CLS
ขนาด	NN	O	I_CLS
ใหญ่	VV	O	I_CLS
_	PU	O	I_CLS
โดย	CC	O	I_CLS
เป็น	VV	O	I_CLS
ชุมชน	NN	O	I_CLS
ชาว	FX	B_ETH	I_CLS
ไทย	NN	I_ETH	I_CLS
-	PU	I_ETH	I_CLS
จีน	NN	E_ETH	I_CLS
ไหหลำ	NN	O	I_CLS
และ	CC	O	I_CLS
แต้จิ๋ว	NN	B_ETH	I_CLS
ดั้งเดิม	AJ	O	I_CLS
_	PU	O	I_CLS
ดัง	PS	O	I_CLS
ปรากฏ	VV	O	I_CLS
ศาล	NN	O	I_CLS
เจ้า	NN	O	I_CLS
ชาว	FX	B_ETH	I_CLS
จีน	NN	E_ETH	I_CLS
อยู่	VV	O	I_CLS
ใน	PS	O	I_CLS
ชุมชน	NN	O	I_CLS
_	PU	O	I_CLS
มี	VV	O	I_CLS
แหล่ง	NN	O	I_CLS
ท่องเที่ยว	VV	O	I_CLS
ที่	CC	O	I_CLS
โดดเด่น	VV	O	I_CLS
_	PU	O	I_CLS
ได้แก่	CC	O	I_CLS
_	PU	O	I_CLS
เขา	NN	B_MOU	I_CLS
มัทรี	NN	E_MOU	I_CLS
_	PU	O	I_CLS
อนุสาวรีย์ยุวชน	NN	B_NPK	I_CLS
ทหาร	NN	E_NPK	I_CLS
_	PU	O	I_CLS
และ	CC	O	I_CLS
มาลิก	NN	B_LOC	I_CLS
เจดีย์	NN	I_LOC	I_CLS
บน	PS	I_LOC	I_CLS
เกาะ	NN	I_LOC	I_CLS
มัตโพน	NN	E_LOC	I_CLS
_	PU	O	I_CLS
เป็นต้น	AV	O	E_CLS
